
text/maps/FuchsiaBillsGrandpasHouse.asm:13:	text "מה את אומרת?"
text/maps/FuchsiaBillsGrandpasHouse.asm:28:	para "אם תבקשי ממנו, אולי"
text/maps/FuchsiaGoodRodHouse.asm:8:	para "גם את אוהבת לדוג?"
text/maps/FuchsiaGym.asm:4:	para "ילדונת קטנה כמוך,"
text/maps/FuchsiaGym.asm:5:	line "מעזה לאתגר..."
text/maps/FuchsiaGym.asm:15:	para "התכונני להרגיש את"
text/maps/FuchsiaGym.asm:22:	line "הראית מה את"
text/maps/FuchsiaGym.asm:25:	para "הנה! קחי את תג"
text/maps/FuchsiaGym_2.asm:43:	text "פני מקום בתיק,"
text/maps/FuchsiaGym_2.asm:44:	line "ילדה!"
text/maps/FuchsiaGym_2.asm:67:	text "אז את משתמשת"
text/maps/FuchsiaGym_2.asm:93:	text "בואי נראה אותך"
text/maps/FuchsiaGym_2.asm:94:	line "מנצחת את הטכניקות"
text/maps/FuchsiaGym_2.asm:112:	text "עצרי!"
text/maps/FuchsiaGym_2.asm:126:	line "קחי רמז!"
text/maps/FuchsiaGym_2.asm:128:	para "חפשי את המעברים"
text/maps/FuchsiaGym_2.asm:156:	para "מאיזו שושלת את"
text/maps/FuchsiaGym_2.asm:157:	line "מגיעה?"
text/maps/FuchsiaGym_2.asm:172:	line "באיזה צד תבחרי?"
text/maps/FuchsiaGym_2.asm:177:	line "אלופצ'יקית!"
text/maps/FuchsiaGym_2.asm:187:	para "תצטרכי למצוא מרווחים"
text/maps/FuchsiaPokecenter.asm:5:	para "זה קשה, אבל את"
text/maps/GameCorner.asm:2:	text "ברוכה הבאה!"
text/maps/GameCorner.asm:4:	para "אם תרצי להחליף את"
text/maps/GameCorner.asm:7:	cont "תוכלי לעשות זאת"
text/maps/GameCorner.asm:12:	text "ברוכה הבאה לROCKET" ; TODO
text/maps/GameCorner.asm:15:	para "את רוצה לקנות"
text/maps/GameCorner.asm:19:	line "¥0001. את"
text/maps/GameCorner.asm:51:	text "אל תספרי לאף אחד."
text/maps/GameCorner.asm:65:	text "ילדה, רוצה לשחק?"
text/maps/GameCorner.asm:73:	text "את לא צריכה את"
text/maps/GameCorner.asm:91:	cont "אלופצ'יקית!"
text/maps/GameCorner.asm:144:	text "רגע, מה? את מסיחה"
text/maps/GameCorner.asm:145:	line "את דעתי! קחי כמה"
text/maps/GameCorner.asm:168:	cont "תסתלקי מכאן, או ש!"
text/maps/GameCorner.asm:186:	cont "קדימה, בואי נלחץ!@@"
text/maps/IndigoPlateauLobby.asm:3:	line "אלופצ'יקית!"
text/maps/IndigoPlateauLobby.asm:6:	line "תאלצי להילחם נגד"
text/maps/IndigoPlateauLobby.asm:11:	para "אם תפסידי, תאלצי"
text/maps/IndigoPlateauLobby.asm:13:	cont "קדימה! את יכולה!"
text/maps/IndigoPlateauLobby.asm:17:	text "מרגע זה, תילחמי"
text/maps/IndigoPlateauLobby.asm:21:	para "אם תביסי את כולם!"
text/maps/LancesRoom.asm:6:	line "העילית! את יכולה"
text/maps/LancesRoom.asm:10:	para "את יודעת, דרקונים"
text/maps/LancesRoom.asm:22:	para "ובכן, את מוכנה"
text/maps/LancesRoom.asm:34:	line "בזה, אבל את"
text/maps/LancesRoom.asm:44:	para "את אלופת ליגת"
text/maps/LancesRoom.asm:50:	cont "הפעם תצטרכי לעמוד"
text/maps/LancesRoom.asm:53:	para "תצטרכי להילחם נגד"
text/maps/LavenderMart.asm:12:	para "את יודעת איפה"
text/maps/LavenderTown.asm:2:	text "את מאמינה"
text/maps/LavenderTown.asm:49:	para "הפכו את הבלתי"
text/maps/LoreleisRoom.asm:2:	text "ברוכה הבאה לליגת"
text/maps/LoreleisRoom.asm:22:	line "את מוכנה?"
text/maps/LoreleisRoom.asm:30:	text "את טובה משחשבתי!"
text/maps/LoreleisRoom.asm:31:	line "תתקדמי לחדר הבא!"
text/maps/LoreleisRoom.asm:40:	line "אל תיסגי!"
text/maps/MrPsychicsHouse.asm:2:	text "חכי! אל"
text/maps/MrPsychicsHouse.asm:3:	line "תגידי מילה..."
text/maps/MrPsychicsHouse.asm:5:	para "את רצית בזה!"
text/maps/MtMoon1F.asm:3:	line "אותי! אה, את!"
text/maps/MtMoon1F.asm:4:	cont "בסך הכל ילדה!"
text/maps/MtMoon1F.asm:18:	text "גם את פה"
text/maps/MtMoon1F.asm:48:	text "מה! אל תתגנבי!"
text/maps/MtMoon1F.asm:80:	cont "מה את?"
text/maps/MtMoon1F.asm:94:	text "עברי דרך המערה"
text/maps/MtMoon1F.asm:107:	cont "אם תתפסי אחד."
text/maps/MtMoon1F.asm:111:	text "היזהרי! האצלף"
text/maps/MtMoonB2F.asm:18:	text "תראי, אין לך מקום"
text/maps/MtMoonB2F.asm:22:	text "היי, עצרי!"
text/maps/MtMoonB2F.asm:67:	text "את עיצבנת אותי!"
text/maps/MtMoonB2F.asm:92:	cont "לכי לעזאזל, ילדונת!"
text/maps/MtMoonB2F.asm:96:	text "אז, את טובה."
text/maps/MtMoonB2F.asm:100:	text "אם את מוצאת מאובן"
text/maps/MtMoonB2F.asm:101:	line "תני לי אותו"
text/maps/MtMoonPokecenter.asm:27:	cont "מה את אומרת?"
text/maps/MtMoonPokecenter.asm:41:	text "איש: שתדעי שאצלי"
text/maps/OaksLab.asm:28:	text "אז את רוצה את"
text/maps/OaksLab.asm:34:	text "אז את רוצה את"
text/maps/OaksLab.asm:40:	text "אז את רוצה את"
text/maps/OaksLab.asm:63:	line "איזה #ימון את"
text/maps/OaksLab.asm:70:	cont "את יכולה להשתמש"
text/maps/OaksLab.asm:77:	line "חנכי את ה#ימון"
text/maps/OaksLab.asm:90:	para "כנראה שאת מאמנת"
text/maps/OaksLab.asm:91:	line "#ימונים מוכשרת!"
text/maps/OaksLab.asm:114:	text "אלון: אם את רוצה"
text/maps/OaksLab.asm:122:	line "השתמשי באלה כדי"
text/maps/OaksLab.asm:140:	para "לא תמיד תצליחי"
text/maps/OaksLab.asm:150:	text "אלון: בואי לבקר"
text/maps/OaksLab.asm:214:	cont "אבל את יכולה לקחת"
text/maps/OaksLab.asm:215:	cont "אחד! בחרי!"
text/maps/OaksLab.asm:246:	text "<RIVAL>: חכי"
text/maps/OaksLab.asm:248:	cont "בואי ננסה קצת"
text/maps/OaksLab.asm:386:	cont "חפשי #ימונים"
text/maps/OaksLab.asm:392:	text "את בכיוון הנכון!"
text/maps/OaksLab.asm:393:	line "קבלי MH הבזק"
text/maps/OaksLab.asm:399:	line "#ימונים! נסי"
text/maps/OaksLab.asm:406:	line "הרבה! קבלי"
text/maps/OaksLab.asm:414:	cont "חפשי את העוזר שלי!"
text/maps/OaksLab.asm:420:	cont "קבלי שיתוף PXE"
text/maps/OaksLab.asm:431:	line "לכי לדוג, אולי"
text/maps/OaksLab.asm:432:	cont "תמצאי #ימוני מים"
text/maps/OaksLab.asm:438:	line "את אוהבת"
text/maps/OaksLab.asm:451:	line "זנים שונים! את"
text/maps/OaksLab.asm:464:	text "נהדר! הציעי לחברים"
text/maps/OaksLab.asm:471:	line "הפכת למקצוענית של"
text/maps/OaksLab.asm:477:	line "התלמידה התעלתה"
text/maps/PalletTown.asm:2:	text "אלון: היי! חכי"
text/maps/PalletTown.asm:3:	line "רגע! אל תלכי!@@"
text/maps/PalletTown.asm:15:	para "בואי איתי!"
text/maps/PewterGym.asm:15:	para "את עדיין רוצה"
text/maps/PewterGym.asm:17:	cont "בסדר גמור! בואי"
text/maps/PewterPokecenter.asm:8:	para "קישטה! לכי!"
text/maps/PewterSpeechHouse.asm:17:	line "מובטח שתצליחי!"
text/maps/PokemonFanClub.asm:2:	text "הביטי בזנב המתוק"
text/maps/PokemonFanClub.asm:57:	line "אז תקשיבי טוב טוב!"
text/maps/PokemonFanClub.asm:65:	cont "את מסכימה?..."
text/maps/PokemonFanClub.asm:76:	cont "...אופס! תראי מה"
text/maps/PokemonFanClub.asm:98:	para "אל תדאגי לגבי,"
text/maps/PokemonFanClub.asm:107:	line "אוהבת רכיבה!"
text/maps/PokemonFanClub.asm:111:	text "הו, תחזרי"
text/maps/PokemonFanClub.asm:128:	text "פני מקום בתיק"
text/maps/PokemonFanClub.asm:146:	line "תחזירי לו גם!"
text/maps/PokemonMansion1F.asm:2:	text "מי את? לא אמור"
text/maps/PokemonMansion1F.asm:12:	line "על מה את מדברת."
text/maps/PokemonMansion3F.asm:26:	text "אז, את תקועה?"
text/maps/PokemonMansion3F.asm:27:	line "נסי לקפוץ למטה"
text/maps/RockTunnelB1F_2.asm:5:	cont "שלך, ילדה!"
text/maps/Route1.asm:6:	line "את מוזמנת לבוא"
text/maps/Route2Gate.asm:11:	cont "תוכלי לעבור דרך"
text/maps/Route3.asm:43:	text "את מאחסנת"
text/maps/Route3.asm:51:	text "את הסתכלת עליי"
text/maps/Route3.asm:56:	text "את"
text/maps/Route3.asm:61:	text "תפסיקי לבהות"
text/maps/Route3.asm:62:	line "אם את לא רוצה"
text/maps/Route3.asm:67:	text "את מאמנת #ימון?"
text/maps/Route3.asm:68:	line "בואי נלחם!"
text/maps/Route3.asm:80:	cont "מקום, פשוט תחליפי"
text/maps/Route3.asm:90:	text "תהיי נחמדה!"
text/maps/Route3.asm:95:	line "אל תתני לאנשים"
text/maps/Route3.asm:100:	text "היי! את לא לובשת"
text/maps/Route3.asm:117:	text "את יכולה להלחם"
text/maps/Route3.asm:136:	line "את נגעת בי?"
text/maps/Route6.asm:3:	line "בבקשה תפסיקי"
text/maps/Route6.asm:18:	text "תסלחי לי!"
text/maps/Route6.asm:34:	line "את צוחקת עליי!"
text/maps/Route6.asm:79:	cont "כמה את מוצלחת?"
text/maps/Route6.asm:83:	text "את"
text/maps/Route8.asm:2:	text "נראה שאת לא רעה ב"
text/maps/Route8.asm:20:	line "גלגלי את הקוביות!"
text/maps/Route8.asm:34:	text "את צריכה אסטרטגיה"
text/maps/Route8.asm:39:	text "את לא"
text/maps/Route8.asm:44:	text "תשלחי את טנפאי"
text/maps/Route8.asm:106:	text "היי! תראי"
text/maps/Route8.asm:144:	para "אל תהיי כזאת מרשעת"
text/maps/Route11Gate1F.asm:4:	cont "שלך אם את תופסת"
text/maps/Route15Gate1F.asm:2:	text "את עובדת על"
text/maps/Route16Gate2F.asm:12:	text "מביטה דרך המשקפת."
text/maps/Route16Gate2F.asm:18:	text "מביטה דרך המשקפת."
text/maps/Route18Gate1F.asm:13:	text "סלחי לי!"
text/maps/Route18Gate2F.asm:2:	text "מביטה דרך המשקפת."
text/maps/Route18Gate2F.asm:10:	text "מביטה דרך המשקפת."
text/maps/Route20.asm:22:	text "תפסיקי!"
text/maps/Route20.asm:46:	text "גם את כאן בחופשה?"
text/maps/Route20.asm:61:	text "קלטי ת'שרירים"
text/maps/Route20.asm:76:	text "למה את רוכבת"
text/maps/Route20.asm:78:	cont "את לא יודעת"
text/maps/Route20.asm:115:	text "שלא תעזי לגעת"
text/maps/Route20.asm:120:	text "את חושבת שהפנינים"
text/maps/Route20.asm:150:	text "חכי!"
text/maps/Route25.asm:8:	text "את"
text/maps/Route25.asm:80:	cont "נרדם, תחזירי אותו"
text/maps/Route25.asm:81:	cont "לכדור ותשלחי אחד"
text/maps/Route25.asm:97:	text "את הגעת מהר הירח?"
text/maps/Route25.asm:98:	line "תוכלי להביא לי"
text/maps/Route25.asm:109:	text "את"
text/maps/Route25.asm:138:	text "את הולכת לראות"
text/maps/Route25.asm:140:	cont "קודם, בואי נלחם!"
text/maps/Route25.asm:144:	text "את"
text/maps/SSAnne1F.asm:7:	line "כל דבר שרק תרצי!"
text/maps/SSAnne1F.asm:9:	para "הא! את טיפוס"
text/maps/SSAnne1F.asm:17:	para "תצפי לאתגרים"
text/maps/SSAnne2F.asm:26:	line "סוגים, חברה!"
text/maps/SSAnne2F.asm:38:	para "לפחות את"
text/maps/SSAnne2F.asm:39:	line "מאמנת את ה#ימונים"
text/maps/SSAnne2F.asm:44:	text "מה קרה !<PLAYER>?"
text/maps/SSAnne2F.asm:48:	line "חברה!"
text/maps/SSAnne2FRooms.asm:66:	text "תראי מה דגתי!"
text/maps/SSAnne2FRooms.asm:82:	text "מה את מעדיפה,"
text/maps/SSAnne2FRooms.asm:103:	text "תרגעי!"
text/maps/SSAnneB1FRooms.asm:6:	text "את יודעת מה"
text/maps/SSAnneB1FRooms.asm:13:	line "אחלה קרב, חברונת!"
text/maps/SSAnneB1FRooms.asm:18:	line "להיות מלח, חברונת?"
text/maps/SSAnneB1FRooms.asm:44:	line "את לא רעה."
text/maps/SSAnneB1FRooms.asm:54:	text "אני מחבב ילדים"
text/maps/SSAnneB1FRooms.asm:65:	cont "עמוקים! את"
text/maps/SSAnneB1FRooms.asm:66:	cont "תצטרכי חכה."
text/maps/SSAnneB1FRooms.asm:70:	text "חברצ'יקה, את"
text/maps/SSAnneB1FRooms.asm:71:	line "תשחי עם כרישים"
text/maps/SSAnneB1FRooms.asm:72:	cont "אם תפסידי!"
text/maps/SSAnneB1FRooms.asm:87:	line "עצרי לפטפט!"
text/maps/SSAnneB1FRooms.asm:107:	line "ממש חזקה!"
text/maps/SafariZoneCenter.asm:8:	para "לחצי על כפתור ה-"
text/maps/SafariZoneWestRestHouse.asm:2:	text "אם תזרקי על"
text/maps/SafariZoneWestRestHouse.asm:10:	text "אם תזרקי פתיון,"
text/maps/SaffronGates.asm:5:	para "היי חכי שם,"
text/maps/SaffronGates.asm:24:	cont "אם את רוצה להגיע"
text/maps/SaffronGates.asm:27:	cont "את יכולה לעבור."
text/maps/SaffronPidgeyHouse.asm:6:	para "היי! אל תציצי במכתב"
text/maps/SilphCo1F.asm:2:	text "ברוכה הבאה!"
text/maps/SilphCo6F.asm:14:	line "בבקשה, עזרי לי!"
text/maps/SilphCo6F.asm:23:	text "תראי אותו! הוא"
text/maps/SilphCo6F.asm:51:	text "בואו לעבוד בסילף"
text/maps/SilphCo6F.asm:90:	text "איך את מעזה לבגוד"
text/maps/SilphCo6F.asm:95:	text "בוגדת!"
text/maps/SilphCo6F.asm:99:	text "אם את בעד צדק,"
text/maps/SilphCo6F.asm:100:	line "את בוגדת ברוע!"
text/maps/SilphCo7F.asm:2:	text "אה! היי! את לא"
text/maps/SilphCo7F.asm:7:	para "אני רוצה שתקחי את"
text/maps/SilphCo7F.asm:21:	para "אני חושב שאת"
text/maps/SilphCo7F.asm:22:	line "תהיי מאמן מצוין"
text/maps/SilphCo7F.asm:63:	text "ואו! את רדפת"
text/maps/SilphCo7F.asm:69:	text "את! זה מאוד"
text/maps/SilphCo7F.asm:72:	cont "אותי? את לא יכולה!"
text/maps/SilphCo7F.asm:82:	line "כאן מסתננת קטנה!"
text/maps/SilphCo7F.asm:91:	text "את לא תמצאי את"
text/maps/SilphCo7F.asm:93:	cont "תתרוצצי כאן מסביב!"
text/maps/SilphCo7F.asm:110:	line "את מאמנת מיומן"
text/maps/SilphCo7F.asm:131:	text "מסיגת גבול קטנה?"
text/maps/SilphCo7F.asm:132:	line "זה בטח את!"
text/maps/SilphCo7F.asm:141:	text "לכי הביתה ילדה"
text/maps/SilphCo7F.asm:170:	line "אז נראה שאת מוכנה"
text/maps/SilphCo7F.asm:178:	para "את לא מספיק"
text/maps/SilphCo7F.asm:179:	line "חזקה כדי לשחק"
text/maps/SilphCo7F.asm:206:	cont "תיזהרי לא להזיע מהלחץ!"
text/maps/SilphCo9F.asm:2:	text "את נראת עייף!"
text/maps/SilphCo9F.asm:3:	line "כדאי שתנוחי רגע!"
text/maps/SilphCo9F.asm:17:	line "מעריץ אותך, ילדה!"
text/maps/SilphCo9F.asm:38:	text "את פגעת"
text/maps/SilphCo9F.asm:45:	cont "תתיחסי לסוגי"
text/maps/SilphCo10F.asm:7:	text "בבקשה אל תספרי"
text/maps/SilphCo10F.asm:12:	text "ברוכה הבאה לקומה"
text/maps/SilphCo10F.asm:40:	text "את מרוצה עכשיו"
text/maps/SilphCo10F.asm:42:	cont "אז הסתלקי לך!"
text/maps/SilphCo11F.asm:16:	cont "תרצי!"
text/maps/SilphCo11F.asm:41:	para "שמרי אותו בסוד."
text/maps/SilphCo11F.asm:66:	para "אל תדחפי את האף"
text/maps/SilphCo11F.asm:70:	para "אחרת, התכונני"
text/maps/SilphCo11F.asm:82:	cont "שתכננו עבור"
text/maps/SilphCo11F.asm:86:	line "לעולם לא תיפלי!"
text/maps/SilphCo11F.asm:88:	para "<PLAYER>! אל תשכחי"
text/maps/SilphCo11F.asm:99:	text "עצרי מיד!"
text/maps/SilphCo11F.asm:100:	line "אל תזוזי!"
text/maps/SilphCo11F.asm:109:	text "אז, את רוצה לפגוש"
text/maps/SilphCo11F.asm:114:	text "עצרי! קבעת פגישה"
text/maps/SilphCo11F.asm:124:	text "תזהרי, הבוס שלי"
text/maps/VermilionCity.asm:24:	text "ברוכה הבאה לספינה"
text/maps/VermilionCity.asm:29:	text "ברוכה הבאה לספינה"
text/maps/VermilionCity.asm:32:	para "סלחי לי, יש לך"
text/maps/VermilionCity.asm:40:	text "נהדר! ברוכה הבאה"
text/maps/VermilionCity.asm:51:	para "את צריכה כרטיס"
text/maps/VermilionGym.asm:2:	text "היי, ילדה! מה"
text/maps/VermilionGym.asm:3:	line "את חושבת שאת"
text/maps/VermilionGym.asm:6:	para "את לא תשרדי"
text/maps/VermilionGym_2.asm:3:	line "ילדה!"
text/maps/VermilionGym_2.asm:20:	cont "בכל זמן, ילדה!"
text/maps/VermilionGym_2.asm:22:	para "את מיוחדת,"
text/maps/VermilionGym_2.asm:23:	line "ילדה! קחי את זה!"
text/maps/VermilionGym_2.asm:38:	para "למדי #ימון חשמל"
text/maps/VermilionGym_2.asm:38:	para "למדי #ימון חשמל"
text/maps/VermilionGym_2.asm:43:	text "הי ילדה, פני מקום"
text/maps/VermilionGym_2.asm:50:	para "את יריבה רצינית,"
text/maps/VermilionGym_2.asm:51:	line "ילדה!"
text/maps/VermilionGym_2.asm:65:	line "את טובה מאוד!"
text/maps/VermilionGym_2.asm:114:	line "אלופצ'יקית!"
text/maps/VermilionGym_2.asm:126:	cont "בסכנה כאן! תיזהרי"
text/maps/VermilionGym_2.asm:133:	para "תצטרכי לפצח את"
text/maps/VermilionOldRodHouse.asm:7:	para "את אוהבת"
text/maps/VermilionOldRodHouse.asm:30:	line "צאי לדוג ותפסי"
text/maps/VictoryRoad1F.asm:3:	line "את מספיק חזקה"
text/maps/VictoryRoad1F.asm:18:	text "אני רואה שאת טובה"
text/maps/VictoryRoad1F.asm:19:	line "אבל בואי נראה עד"
text/maps/VictoryRoad1F.asm:30:	line "את טובה יותר"
text/maps/VictoryRoad2F.asm:17:	line "נסי להזיז כמה"
text/maps/VictoryRoad2F.asm:22:	text "אה, אז את רוצה"
text/maps/VictoryRoad2F.asm:48:	text "את השגת"
text/maps/VictoryRoad2F.asm:54:	text "אם תצליחי לעבור"
text/maps/VictoryRoad2F.asm:55:	line "את החלק הזה, את"
text/maps/VictoryRoad2F.asm:56:	cont "תוכלי לפגוש את"
text/maps/VictoryRoad3F.asm:3:	line "על ילדת פלא!"
text/maps/VictoryRoad3F.asm:17:	text "בואי נראה"
text/maps/VictoryRoad3F.asm:18:	line "כמה את טובה!"
text/maps/VictoryRoad3F.asm:44:	cont "ה#ימון! תיזהרי!"
text/maps/VictoryRoad3F.asm:55:	line "חזקה כל כך!"
text/maps/ViridianCity.asm:8:	line "יכולה לסחב אותם"
text/maps/ViridianCity.asm:60:	text "את לא יכולה לעבור"
text/maps/ViridianCity.asm:79:	line "הנה, את יכולה"
text/maps/ViridianCity.asm:103:	para "כמובן שאת יכולה"
text/maps/ViridianCity.asm:106:	para "את ממהרת?"
text/maps/ViridianCity.asm:110:	text "אני רואה שאת עושה"
text/maps/ViridianCity.asm:113:	para "כשאת תופסת"
text/maps/ViridianCity.asm:117:	para "מה? את לא יודעת"
text/maps/ViridianCity.asm:127:	line "תמשיכי ללכת."
text/maps/ViridianCity.asm:131:	text "בהתחלה, את צריכה"
text/maps/ViridianCity.asm:146:	para "תפסי #ימונים"
text/maps/ViridianCity.asm:165:	line "רפאי את ה#ימון"
text/maps/ViridianForest.asm:12:	cont "בואי נילחם!"
text/maps/ViridianForest.asm:22:	text "ששש! את תבריחי"
text/maps/ViridianForest.asm:27:	text "יו! את לא יכולה"
text/maps/ViridianForest.asm:29:	cont "מאמנת #ימון!"
text/maps/ViridianForest.asm:45:	text "הי, חכי!"
text/maps/ViridianForest.asm:46:	line "לאן את ממהרת?"
text/maps/ViridianForest.asm:51:	line "את טובה!"
text/maps/ViridianForest.asm:55:	text "לפעמים את יכולה"
text/maps/ViridianForest.asm:75:	para "אם את רוצה"
text/maps/ViridianForest.asm:77:	cont "תתרחקי מהדשא!"
text/maps/ViridianForest.asm:81:	text "השתמשי בנוגדן כדי"
text/maps/ViridianForest.asm:90:	para "אם תיצרי קשר דרך"
text/maps/ViridianForest.asm:102:	cont "אחרים! תפסי"
text/maps/ViridianForest.asm:110:	para "החלישי את ה#ימונים"
text/maps/ViridianForestNorthGate.asm:6:	para "את צריכה לחפש"
text/maps/ViridianForestSouthGate.asm:2:	text "את הולכת"
text/maps/ViridianForestSouthGate.asm:4:	cont "תיזהרי, היער הזה"
text/maps/ViridianMart.asm:2:	text "אוקי! מסרי דרישת"
text/maps/ViridianMart.asm:13:	text "את מכירה את פרופ'"
text/maps/ViridianMart.asm:17:	line "את יכולה למסור"
text/maps/ViridianPokecenter.asm:2:	text "את יכולה להשתמש"
text/maps/ViridianSchoolHouse.asm:10:	para "השתדלי לקרוא"
text/maps/WardensHouse.asm:33:	text "פקח: תודה, ילדה!"
text/maps/WardensHouse.asm:38:	line "ככה. הרשי לי"
text/maps/WardensHouse.asm:55:	cont "כאשר את"
text/maps/WardensHouse.asm:62:	para "אם את מוצאת, את"
text/oakspeech.asm:37:	line "את והוא יריבים"
text/oakspeech.asm:54:	cont "רק לך! בואי נתחיל!"